0 3 1 5 7 6 4 4 9
3 0 1 6 1 3 3 9 7
1 1 0 6 3 6 7 7 9
5 6 6 0 1 2 4 8 2
7 1 3 1 0 8 3 8 8
6 3 6 2 8 0 6 7 7
4 3 7 4 3 6 0 1 9
4 9 7 8 8 7 1 0 8
9 7 9 2 8 7 9 8 0